XXXXXXXXXXXXXXXXXXXX
X         X        X
X         X        X
X         X        X
X         X        X
X         X        X
X         X        X
X         X        X
X         X        X
XXXXXXXXXXWXXXXXXXXX
X         X        X
X         X        X
X         X        X
X         X        X
X         X        X
X         X        X
X         X        X
X         X        X
X         X        X
XXXXXXXXXXXXXXXXXXXX